13x29* o12$
**************************1**$
*   *    * * *          * * *$
** *     **      *          *$
*         *   *          *  *$
**                  **  *  **$
*    ** *    *   ***        *$
*         ** * **         * *$
*        * *   * **      *  *$
*** * ** *          *       *$
*   *  ** *  *    *   **  * *$
*   *   * *    * *    *     *$
***                *       **$
*****2***********************$
